___2_4_4_4_4___
_4_1___________
_4_111111111_4_
___________1___
2111_4_4_4_1_4_
___1_______1___
_4_111111111_4_
_________1_____
___4_4_4_1_____
_________3_____